8 8 8 4 4 4 4 4 4 4 4 4 4 4 4 4 4 4 4 4 4 4 4 4 4 4 4 4 4 4 4 4 4 4 4 4 4 4 4 4 4 4 4 4 4 4 4
8 8 8 8 4 4 4 4 4 4 4 4 4 4 4 4 4 4 4 4 4 4 4 4 4 4 4 4 4 4 4 4 4 4 4 4 4 4 4 4 4 4 4 4 4 4 4
8 8 8 8 8 4 4 4 4 4 4 4 40 41 42 4 4 4 4 4 4 4 4 4 4 4 4 4 4 4 4 4 4 4 4 4 4 4 4 4 4 4 4 4 4 4 4
8 8 8 8 8 8 4 4 4 30 4 4 43 44 45 4 4 4 4 4 4 4 4 4 4 4 4 4 4 4 4 4 4 4 4 4 4 4 4 4 4 4 4 4 4 4 4
8 8 8 8 8 8 8 4 4 4 4 4 4 4 4 4 4 4 4 4 4 4 4 4 4 4 4 4 4 4 4 4 4 4 4 4 4 4 4 4 4 4 4 4 4 4 4
8 8 8 8 8 8 8 8 4 4 4 4 4 4 4 4 4 4 46 4 4 4 4 4 4 4 4 4 4 4 4 4 4 4 4 4 4 4 4 4 4 4 4 4 4 4 4
8 8 8 8 8 8 8 8 8 27 31 27 31 4 4 4 4 4 4 4 4 4 4 4 4 4 4 4 4 4 4 4 4 4 4 4 4 4 4 4 4 4 4 4 4 4 4 4
8 8 8 8 8 8 8 8 8 8 4 4 4 8 8 4 4 4 4 4 4 4 32 38 33 4 4 4 4 4 4 4 4 4 4 4 4 4 4 4 4 4 4 4 4 4 4
8 8 8 8 8 8 8 8 8 4 0 0 0 0 0 0 0 0 0 0 0 0 34 39 35 7 1 1 3 0 0 0 0 0 0 0 10 4 4 4 4 4 4 4 4 4 4
8 8 8 8 8 8 8 8 4 4 7 1 1 1 3 0 0 7 1 1 1 3 0 14 0 6 0 0 9 1 1 1 1 1 1 1 3 4 4 4 4 4 4 4 4 4 4
8 8 8 8 8 8 8 4 4 4 6 8 0 17 6 0 27 6 0 0 0 6 0 9 1 11 10 0 0 0 27 28 27 28 27 28 6 4 4 4 4 4 4 4 4 4 4
8 8 8 8 8 8 4 4 4 4 6 0 0 17 6 0 27 6 0 14 0 6 8 0 0 0 7 1 1 3 0 7 1 1 13 0 6 4 4 4 4 4 4 4 4 4 4
8 8 8 8 8 4 4 4 4 4 6 0 7 1 5 13 27 6 0 6 0 9 1 1 3 0 6 0 0 6 12 6 0 0 0 0 6 4 4 4 4 4 4 4 4 4 4
8 8 8 8 4 4 4 4 4 4 6 0 6 10 0 0 0 6 0 6 0 0 0 37 6 0 6 0 0 6 0 6 10 7 1 18 11 4 4 4 4 4 4 4 4 4 4
8 8 8 4 4 4 4 4 4 4 6 8 6 0 2 3 12 9 1 11 0 17 7 1 5 1 11 0 0 6 0 6 0 6 0 6 0 4 4 4 4 4 4 4 4 4 4
8 8 4 4 4 4 4 4 4 4 6 0 6 0 0 6 0 0 0 0 0 17 6 8 10 0 0 0 0 9 1 5 1 11 0 6 0 4 4 4 4 40 41 42 4 4 4
8 4 4 4 4 4 4 4 4 4 6 0 9 1 1 5 1 1 1 3 0 17 6 10 0 31 30 31 30 31 30 31 30 31 30 6 0 4 4 4 4 43 44 45 4 4 4
8 8 4 4 4 4 4 4 4 4 6 17 28 17 0 0 0 0 0 6 0 17 6 0 0 7 1 1 1 1 1 1 18 1 1 11 0 4 4 4 4 4 4 4 4 4 4
8 8 8 4 4 4 4 4 4 4 9 1 1 1 1 1 1 1 1 19 1 1 11 0 0 6 0 0 0 0 0 0 6 0 0 0 0 4 4 4 4 4 4 4 4 4 4
8 8 8 8 4 4 4 4 4 4 0 0 12 0 0 0 0 0 0 6 0 0 0 0 0 6 0 0 0 0 7 1 11 0 0 0 0 4 4 4 4 4 4 4 4 4 4
8 8 8 8 8 4 4 4 4 4 7 1 1 1 1 1 1 3 0 9 1 1 3 0 0 6 0 0 0 0 6 0 0 0 0 0 0 4 4 4 4 4 4 4 4 4 4
8 8 8 8 8 8 4 4 4 4 6 0 0 0 0 0 0 6 0 12 0 8 6 10 0 9 1 1 3 0 6 0 0 0 0 0 0 4 4 4 4 4 4 4 4 4 4
8 8 8 8 8 8 8 4 4 4 6 0 0 2 1 3 0 6 12 20 21 0 6 0 0 0 0 0 6 0 9 1 3 0 0 0 0 4 4 4 4 4 4 4 4 4 4
8 4 4 4 4 4 4 8 46 4 6 10 0 0 0 6 0 6 0 25 24 0 6 0 7 13 0 0 6 0 0 0 6 0 0 0 0 4 4 4 4 4 4 4 4 4 4
8 4 4 40 41 42 4 4 4 4 9 1 1 1 1 11 0 6 0 23 22 10 6 0 9 1 1 1 11 0 0 0 9 3 0 0 0 4 4 4 4 4 4 4 4 4 4
8 4 4 43 44 45 4 4 4 4 0 0 0 0 0 0 0 6 0 0 0 8 6 0 0 0 0 0 0 0 0 0 0 6 0 0 37 4 4 4 4 4 4 4 4 4 4
8 4 27 4 4 4 4 4 4 4 2 1 1 1 1 1 1 5 1 1 1 1 5 1 1 1 1 1 1 1 1 1 1 5 1 1 13 4 4 4 4 4 4 4 4 4 4
8 4 4 29 4 4 4 27 4 4 4 4 4 4 4 4 4 4 46 4 4 4 4 4 4 4 4 4 4 4 4 4 4 4 4 4 4 4 4 4 4 4 4 4 4 4 4
8 4 4 4 30 4 4 4 4 4 4 4 4 4 4 4 4 4 4 4 4 40 41 42 4 4 4 4 4 4 4 4 4 4 4 4 4 4 4 4 4 4 4 4 4 4 4
8 8 4 4 4 4 29 30 4 4 4 4 4 4 4 4 4 4 4 4 4 43 44 45 4 4 4 4 4 4 4 4 4 4 4 4 4 4 4 4 4 4 4 4 4 4 4
8 8 8 27 4 4 4 4 4 4 4 4 4 4 4 4 4 4 4 4 4 4 4 4 4 4 4 4 4 4 4 4 4 4 4 4 4 4 4 4 4 4 4 4 4 4 4
8 8 8 8 8 8 8 8 4 4 4 4 4 4 4 4 4 4 4 4 4 4 4 4 4 4 4 4 4 4 4 4 4 4 4 4 4 4 4 4 4 4 4 4 4 4 4
8 8 8 8 8 8 8 8 8 8 4 4 4 4 4 4 4 4 4 4 4 4 4 4 4 4 4 4 4 4 4 4 4 4 4 4 4 4 4 4 4 4 4 4 4 4 4
8 8 8 8 8 8 8 8 8 8 8 8 8 4 4 4 4 4 4 4 4 4 4 4 4 4 4 4 4 4 4 4 4 4 4 4 4 4 4 4 4 4 4 4 4 4 4
8 8 8 8 8 8 8 8 8 8 8 8 8 8 8 8 8 8 8 8 8 8 8 8 8 8 8 8 8 8 8 8 8 8 8 8 8 8 8 8 8 8 8 8 8 8 8
8 8 8 8 8 8 8 8 8 8 8 8 8 8 8 8 8 8 8 8 8 8 8 8 8 8 8 8 8 8 8 8 8 8 8 8 8 8 8 8 8 8 8 8 8 8 8