64 64 64 64 64 64 64 64 64 64 64 64 64 64 64 64 64 64 64 64 64 64 64 64 64 64 64 64 64 64 64 64 64 64 64 64 64 64 64 64 64 64 64 64 64 64 64
64 64 64 64 64 64 64 64 64 64 64 64 64 64 64 64 64 64 64 64 64 64 64 64 64 64 64 64 64 64 64 64 64 64 64 64 64 64 64 64 64 64 64 64 64 64 64
64 64 64 64 64 64 64 64 64 64 64 64 64 64 64 64 64 64 64 64 64 64 64 64 64 64 64 64 64 64 64 64 64 64 64 64 64 64 64 64 64 64 64 64 64 64 64
64 64 64 64 64 64 64 64 64 64 64 64 64 64 64 64 64 64 64 64 64 64 64 64 64 64 64 64 64 64 64 64 64 64 64 64 64 64 64 64 64 64 64 64 64 64 64
64 64 64 64 64 64 64 64 64 64 64 64 64 64 64 64 64 64 64 64 64 64 64 64 64 64 64 64 64 64 64 64 64 64 64 64 64 64 64 64 64 64 64 64 64 64 64
64 64 64 64 64 64 64 64 64 64 64 64 64 64 64 64 64 64 64 64 64 64 64 64 64 64 64 64 64 64 64 64 64 64 64 64 64 64 64 64 64 64 64 64 64 64 64
64 64 64 64 64 64 64 78 76 76 76 76 76 76 76 76 76 76 76 76 76 76 76 76 76 76 76 76 76 76 76 76 76 76 76 76 76 76 76 77 64 64 64 64 64 64 64
64 64 64 64 64 64 64 73 81 63 81 63 63 63 63 63 63 63 63 63 63 63 63 63 63 63 81 63 67 63 63 63 63 63 70 63 63 63 63 74 64 64 64 64 64 64 64
64 64 64 64 64 64 64 73 82 63 82 67 63 63 63 63 63 63 63 63 63 63 63 63 63 63 82 63 63 81 63 63 63 71 63 63 63 63 63 74 64 64 64 64 64 64 64
64 64 64 64 64 64 64 73 63 67 63 63 63 63 63 63 63 63 63 63 69 63 63 63 63 63 63 67 63 82 63 63 70 84 86 88 63 63 63 74 64 64 64 64 64 64 64
64 64 64 64 64 64 64 73 63 63 67 63 63 63 63 63 63 63 63 63 63 63 63 63 63 63 63 63 63 63 83 63 71 85 87 89 63 63 63 74 64 64 64 64 64 64 64
64 64 64 64 64 64 64 73 63 63 63 63 63 63 63 63 63 63 63 63 63 63 63 63 63 63 63 63 63 63 63 63 63 63 63 63 63 63 63 74 64 64 64 64 64 64 64
64 64 64 64 64 64 64 73 63 63 63 63 63 63 63 83 63 63 63 63 63 63 63 63 63 63 63 63 63 63 63 67 63 63 63 63 63 63 63 74 64 64 64 64 64 64 64
64 64 64 64 64 64 64 73 63 63 63 63 63 63 63 63 81 63 63 63 63 63 63 63 63 63 71 63 63 63 63 63 63 63 63 63 63 63 72 74 64 64 64 64 64 64 64
64 64 64 64 64 64 64 73 63 63 63 83 63 63 63 63 82 63 63 63 63 68 63 63 63 70 63 63 63 63 63 63 63 63 63 63 63 63 63 74 64 64 64 64 64 64 64
64 64 64 64 64 64 64 73 63 63 63 63 63 63 63 63 63 67 63 63 63 63 63 63 71 63 70 63 63 63 63 63 63 63 63 63 63 63 63 74 64 64 64 64 64 64 64
64 64 64 64 64 64 64 73 63 63 68 63 63 63 63 63 67 63 63 63 63 63 63 63 63 63 63 63 63 63 63 63 63 63 63 63 63 63 63 74 64 64 64 64 64 64 64
64 64 64 64 64 64 64 73 63 63 63 63 63 63 63 63 63 63 70 63 63 63 63 63 63 63 63 63 63 63 63 63 63 63 63 63 63 63 63 74 64 64 64 64 64 64 64
64 64 64 64 64 64 64 73 63 63 63 63 63 63 63 63 63 63 83 63 63 63 63 63 63 63 63 63 63 63 63 63 63 63 63 63 63 63 63 74 64 64 64 64 64 64 64
64 64 64 64 64 64 64 73 63 63 63 63 63 63 63 63 63 63 63 63 63 63 63 63 63 63 63 63 63 63 63 63 63 63 63 63 63 63 63 74 64 64 64 64 64 64 64
64 64 64 64 64 64 64 73 63 63 63 63 63 68 63 63 69 63 63 63 63 63 63 63 68 63 63 63 63 63 63 63 63 63 63 63 63 63 63 74 64 64 64 64 64 64 64
64 64 64 64 64 64 64 73 63 63 63 63 83 63 63 63 63 63 63 63 63 63 63 70 63 70 63 63 63 63 63 63 63 63 63 63 63 63 63 74 64 64 64 64 64 64 64
64 64 64 64 64 64 64 73 63 69 63 63 63 63 63 63 63 63 63 63 63 63 63 63 63 63 71 63 69 63 63 63 63 63 63 63 63 63 81 74 64 64 64 64 64 64 64
64 64 64 64 64 64 64 73 63 63 63 63 63 63 63 63 63 63 63 63 63 63 63 63 63 63 63 70 63 63 63 63 63 63 63 63 63 63 82 74 64 64 64 64 64 64 64
64 64 64 64 64 64 64 73 71 63 63 63 63 63 63 63 63 63 63 63 63 63 63 72 63 63 63 63 63 63 63 63 63 63 63 63 70 67 63 74 64 64 64 64 64 64 64
64 64 64 64 64 64 64 73 63 70 63 63 63 63 63 63 63 63 63 63 63 63 63 63 63 63 70 63 63 63 63 63 63 63 63 63 63 63 63 74 64 64 64 64 64 64 64
64 64 64 64 64 64 64 73 63 63 63 63 63 63 63 63 63 63 63 63 63 63 63 63 63 71 63 63 63 63 63 63 63 63 63 63 63 67 63 74 64 64 64 64 64 64 64
64 64 64 64 64 64 64 73 63 63 63 63 63 63 63 63 63 63 63 63 63 63 63 63 63 63 63 63 63 63 63 68 63 63 63 63 63 63 63 74 64 64 64 64 64 64 64
64 64 64 64 64 64 64 73 63 63 63 63 63 63 63 63 72 63 63 63 63 63 63 63 63 63 63 63 63 63 63 63 63 63 63 63 63 63 63 74 64 64 64 64 64 64 64
64 64 64 64 64 64 64 75 65 65 65 65 65 65 65 65 65 65 65 65 65 65 65 65 65 65 65 65 65 65 65 65 65 65 65 65 65 65 65 79 64 64 64 64 64 64 64
64 64 64 64 64 64 64 64 64 64 64 64 64 64 64 64 64 64 64 64 64 64 64 64 64 64 64 64 64 64 64 64 64 64 64 64 64 64 64 64 64 64 64 64 64 64 64
64 64 64 64 64 64 64 64 64 64 64 64 64 64 64 64 64 64 64 64 64 64 64 64 64 64 64 64 64 64 64 64 64 64 64 64 64 64 64 64 64 64 64 64 64 64 64
64 64 64 64 64 64 64 64 64 64 64 64 64 64 64 64 64 64 64 64 64 64 64 64 64 64 64 64 64 64 64 64 64 64 64 64 64 64 64 64 64 64 64 64 64 64 64
64 64 64 64 64 64 64 64 64 64 64 64 64 64 64 64 64 64 64 64 64 64 64 64 64 64 64 64 64 64 64 64 64 64 64 64 64 64 64 64 64 64 64 64 64 64 64
64 64 64 64 64 64 64 64 64 64 64 64 64 64 64 64 64 64 64 64 64 64 64 64 64 64 64 64 64 64 64 64 64 64 64 64 64 64 64 64 64 64 64 64 64 64 64
64 64 64 64 64 64 64 64 64 64 64 64 64 64 64 64 6 64 64 64 64 64 64 64 64 64 64 64 64 64 64 64 64 64 64 64 64 64 64 64 64 64 64 64 64 64 64 64

