62 62 62 62 62 62 62 62 62 62 62 62 62 62 62 62 62 62 62 62 62 62 62 62 62 62 62 62 62 62 62 62 62 62 62 62 62 62 62 62 62 62 62 62 62 62 62
62 62 62 62 62 62 62 62 62 62 62 62 62 62 62 62 62 62 62 62 62 62 62 62 62 62 62 62 62 62 62 62 62 62 62 62 62 62 62 62 62 62 62 62 62 62 62
62 62 62 62 62 62 62 62 62 62 62 62 62 62 62 62 62 62 62 62 62 62 62 62 62 62 62 62 62 62 62 62 62 62 62 62 62 62 62 62 62 62 62 62 62 62 62
62 62 62 62 62 62 62 62 50 62 62 62 62 62 51 62 62 62 62 62 62 62 62 62 62 62 62 62 62 62 62 62 51 62 47 62 62 62 62 62 62 62 62 62 62 62 62
62 62 62 62 62 62 62 49 62 52 62 50 62 49 62 62 62 62 62 62 62 62 62 62 62 62 62 62 62 62 62 62 62 50 62 49 62 62 62 62 62 62 62 62 62 62 62
62 62 62 62 62 62 62 62 62 62 51 62 51 62 62 62 62 62 62 62 62 62 62 62 62 62 62 62 62 62 62 62 62 62 62 62 50 62 62 62 62 62 62 62 62 62 62
62 62 62 62 62 62 62 48 62 62 62 62 62 62 62 62 62 62 62 62 62 62 62 62 62 62 62 62 62 62 62 62 62 62 62 62 62 51 62 62 62 62 62 62 62 62 62
62 62 62 62 62 62 62 62 54 55 55 48 55 48 50 51 55 55 55 54 55 55 55 55 55 55 55 55 55 55 55 55 55 55 55 55 55 55 50 62 62 62 62 62 62 62 62
62 62 62 62 62 62 62 51 55 54 55 55 49 55 55 55 52 55 55 55 50 55 55 55 55 55 55 55 55 55 55 55 55 55 55 55 55 55 50 62 62 62 62 62 62 62 62
62 62 62 62 62 62 62 52 55 55 54 55 55 52 55 55 55 48 55 49 55 49 55 55 55 55 55 55 55 54 55 55 55 55 55 55 55 55 51 62 62 62 62 62 62 62 62
62 62 62 62 62 62 62 48 55 54 55 55 55 55 50 55 55 55 47 55 55 55 48 55 49 55 55 55 55 55 49 55 55 55 55 55 55 55 62 62 62 62 62 62 62 62 62
62 62 62 62 62 62 62 52 54 55 53 48 55 47 55 55 54 55 55 55 55 55 55 50 55 52 55 55 55 55 55 50 55 55 50 55 55 55 62 62 62 62 62 62 62 62 62
62 62 62 62 62 62 62 51 55 54 54 50 55 47 54 55 55 55 55 55 55 49 55 55 55 55 49 55 55 55 55 55 47 55 55 52 50 51 62 62 62 62 62 62 62 62 62
62 62 62 62 62 62 62 50 55 55 54 48 55 55 55 51 55 54 55 55 52 55 48 55 55 55 55 55 55 55 55 55 55 55 48 56 58 60 62 62 62 62 62 62 62 62 62
62 62 62 62 62 51 62 62 54 54 55 49 55 55 52 54 49 55 55 55 51 55 55 50 55 55 55 55 48 55 51 55 47 55 50 57 59 61 62 62 62 62 62 62 62 62 62
62 62 62 62 50 62 50 62 49 54 55 52 54 50 55 55 55 48 47 50 55 55 55 55 55 55 55 55 55 52 52 55 55 55 49 55 55 50 62 50 62 62 62 62 62 62 62
62 62 62 49 62 62 62 48 55 54 55 50 55 51 54 55 55 55 55 55 55 47 55 55 55 55 55 55 55 55 55 50 55 52 55 55 55 55 51 62 62 62 62 62 62 62 62
62 62 48 62 62 62 47 62 55 55 54 52 55 54 49 55 55 55 55 55 51 55 55 50 55 55 55 55 55 55 47 55 55 55 55 55 55 47 62 62 62 62 62 62 62 62 62
62 62 62 62 62 49 48 48 55 50 50 55 54 55 55 48 55 55 54 52 55 55 55 55 51 55 55 55 55 48 55 52 55 55 55 55 55 55 48 62 62 62 62 62 62 62 62
62 62 62 62 50 51 62 62 55 55 54 55 55 55 55 55 47 55 55 55 48 55 55 55 55 48 55 55 49 55 50 55 55 55 55 55 55 55 62 49 62 62 62 62 62 62 62
62 62 62 52 62 62 51 62 55 55 55 55 54 55 55 55 55 52 55 54 54 47 55 54 55 55 55 55 55 50 55 49 55 55 55 55 55 55 52 62 52 62 62 62 62 62 62
62 62 62 62 62 50 62 62 55 55 54 55 55 54 55 55 55 55 48 55 55 55 50 55 55 55 52 55 55 55 55 55 47 55 55 55 55 55 62 51 62 50 62 62 62 62 62
62 62 62 62 62 62 62 62 55 55 55 55 54 55 55 54 55 51 55 50 54 52 55 55 55 55 55 49 55 55 55 55 55 52 55 55 55 55 62 50 62 51 62 62 62 62 62
62 62 52 62 62 62 62 62 55 55 55 54 55 55 55 55 55 55 55 55 49 55 55 54 55 55 55 55 48 55 55 55 51 55 55 55 55 55 48 62 50 62 62 62 62 62 62
62 50 62 51 50 62 62 62 55 54 55 49 48 47 55 54 55 54 55 55 55 55 55 55 55 55 54 55 55 55 55 48 55 55 55 55 55 47 62 51 62 62 62 62 62 62 62
48 62 62 48 50 49 62 62 55 55 55 55 55 55 50 55 55 55 55 55 55 55 54 55 55 55 55 55 55 55 55 55 55 55 55 55 50 55 50 62 62 62 62 62 62 62 62
62 62 52 62 40 41 42 62 54 55 55 55 55 55 55 51 54 55 55 55 54 55 55 55 55 49 55 55 54 55 50 52 55 49 55 51 55 51 62 62 62 62 62 62 62 62 62
62 62 62 51 43 44 45 62 54 55 47 55 55 55 55 55 48 54 55 54 55 55 55 55 55 50 55 47 55 51 55 55 55 55 52 55 52 55 62 62 62 62 62 62 62 62 62
62 62 62 62 47 62 62 62 51 55 55 48 55 55 55 55 55 55 55 54 55 55 54 55 55 55 55 55 55 55 55 55 55 55 55 48 55 55 62 62 62 62 62 62 62 62 62
62 62 62 62 62 47 62 62 52 55 55 55 47 51 47 48 49 47 51 47 50 47 50 51 47 49 50 51 48 47 51 50 49 55 55 55 49 55 62 62 62 62 62 62 62 62 62
62 62 62 62 62 62 62 62 50 62 62 48 62 62 62 62 62 62 62 62 62 62 62 62 62 62 62 62 62 62 62 62 62 52 62 62 62 50 62 62 62 62 62 62 62 62 62
62 62 62 62 62 62 62 62 62 49 50 62 62 62 62 62 62 62 62 62 62 62 62 62 62 62 62 62 62 62 62 62 62 62 51 62 48 62 62 62 62 62 62 62 62 62 62
62 62 62 62 62 62 62 62 62 47 62 52 62 62 62 62 62 62 62 62 62 62 62 62 62 62 62 62 62 62 62 62 62 62 62 50 62 62 62 62 62 62 62 62 62 62 62
62 62 62 62 62 62 62 62 62 62 62 62 48 62 62 62 62 62 62 62 62 62 62 62 62 62 62 62 62 62 62 62 62 62 62 62 62 62 62 62 62 62 62 62 62 62 62
62 62 62 62 62 62 62 62 62 62 62 62 62 62 62 62 62 62 62 62 62 62 62 62 62 62 62 62 62 62 62 62 62 62 62 62 62 62 62 62 62 62 62 62 62 62 62
62 62 62 62 62 62 62 62 62 62 62 62 62 62 62 62 62 62 62 62 62 62 62 62 62 62 62 62 62 62 62 62 62 62 62 62 62 62 62 62 62 62 62 62 62 62 62
        